444444444444444444444444444444444444444444444444444444444444444444444444444444444444444444444444444444444444444444444444444444444444444444444444444444-
422200112122100020110211211221202022021122112210121120212220000201222022010202221002122211212211111222200012112101122100200012000112011022110012122114-
400022110002212200101010212111102102021202011011101200000211202102200222022120121110222022000001100001001100200201101202021102100100221111220120112114-
400210102221210001021121221120121122201121011211002022110212111100202020101102012001012221012010122221201221020121002120011201012100102011200120000014-
410122020100001102201010100011102000220022222102112001122200120012022100112221001111100111000102001122202022200111100220021101002002221112210121011124-
410101212202021022112002222111000200212102001112000000102222122020110222012221210200011101100010201201011111220102122001121112102021112211221111122004-
412111010201201020211200212111022102210010002002002102222222101002200220020011210000021220122000102110222120221200211101110110020021122200122122212004-
420222012110200021111010022120021020121212120222102120001011112210001120222220222011120121221220210012220012022102210221120201022200002112011122122114-
411121202212212102000100100001211200210100200010222220100002012211211102222102121000200012210012201021022202210112211012002120210202222122121111211214-
411211112221211221112121101122010011111121110000020122222211101202102001202221112021201112012110200020102100022200120210120222202120112102121020001114-
422101102001212220112210202010020202202020110120120112101111001100201111112212000002121100211022200111121011122222200210221010210120202221201022010224-
421100101121122110202221102221112102220212212101220111001010221110012112120200120102100012220212202020201021000211120200012011011211211000112102021214-
410010220111111100200021001211020210210110201020012122112112000022000120121012010211100222010100211120100220211011011121120201011101022121222211000204-
400010201211220100001101222011111200022021021022010201200121210020220220010102010021221102012211020112011121111021221020021111011022102201122110212104-
400011111100002221202210100221122000001000022121111021210021022121211201011221121102212120101100011210000121020201011210021120220111111101222111220024-
412120210002022012110212011112201201001121200100220000110022201011220001001002220111001221010020111010211221000102101211100110101202012111112212222214-
400122101000020200001011112020102210201100001122001210202100022021200110021122102100220202112021010201120210101210211102001220011100121110012110102024-
421122100222202121002112020111220222020010012020221002111221120001100101101101002210120220112221202102122002010022110211012012001111202000012111212024-
411001102202210022101212022200120001120020211121222210220121121220022222120012212020002012221021222210120200200100002022212000011222122112102022110114-
410122010021211211010220022202221002202010020210210102210110220111021122022100121011021121101210200210212012002010222011112010012221212102222112220104-
402010121222020010021011211102121110222222222222011110212202102021120110101201211212112110112200102100212112120221002120101221110222001000220000100014-
410011202021212002011022110112010022101010201102001012011100010011221020101022102210121112122012101000000110020121121111220120001012210120022222112014-
422022012012220102122112201120112111000021002210201002112221112121121112200010211210022202212100001212000102100102101021200111111201012202102012012124-
402200020021001112210012120020201120022102012021101202011012222121212101001111012012220210200211012110100102021201211112100201211210021111211210100114-
400111011202010012101221220002000021111201201021010220012010210000211002010010112221210001212211110000210201211012111122220020110000022010122110101214-
410002211111020020202112010001122200222122221101222010211212211021110021211021000220112012220010100102010102011120202202201122101022121200200021202214-
411000002122111120002102021120100000200111001110110011200122102110220001220022100222011001122210000110202220011122220000120211022002210011222021211104-
410111022021012210001220110212110122112112010222221222022100112111122101002101102010212112020002010122010020200211122220220200120100100112220020002114-
402100202010002200220002200210010200011220102022201200220011100022211220210012221110220200211200012201222011022111112211011202102100202200002020120014-
420121212121012201110200102000120022022101111000102102222011220022122220201111210202210111121002122002122101012102021222100210022011102111210001200024-
421010212210112011121101021212122200001002200220020002002122202212002102020102020220111202121210121221021020111122011021101022211201012210010100010224-
420121020110211102020121012000110000111221220110201002012010010212121020102110011101220111221211222002100012102200211212210102111201121222102222112124-
421012220212222002121011202212210100222211100211101221001022111002021111120222000021001202020010011110001110012110210200201012112210202211212021012124-
401102120101212002210112012222111011210210222201202101100201212020100022000101002002000001210120021211012022200021011112012012222201212022221210110224-
401110111100112001201222210110100210000201012121120012221001021211210001212110121212201221012112020211000211101111202000120110011000001101221111101224-
421020221211102200200111220202221202000210220210201112111111112001102010102112122222110000111222200102020121220020211221101110121102222100200121220114-
410100101121011120122201100110010012202021012210001220010011001202022212011220221011202222210120022022121120220111112210101122020202111210000220120024-
420102110000112112111110012101212012202201102211021122100020120010221210002021222221121110121100022121211002100110122212201122122022021122011120200124-
420220002021221212110101102000110212120122011020222211110022102101111210102121222201111011010001022101120012020011200122021121002021200220211211101014-
401120001122011210020100101021221101211120121222221201010222120221020020121210111110022222002221121110210221120201122012212020110220212111222222001124-
412122100020110120120112102112211020100122221122101102102102010220000200211202020002121221210112001102220211110221102122021211121102021210002000111224-
411202012121121210212001001201002102222210200022102210012120110100111122012020010200200200220121100122211120210220010022100210021010020222022101101224-
402110222210121201011211220222022002121200202102201011010001012001010112221121122021020110201220222212201122202112212212002211112122201021201220011204-
422210021001101100222000212020210120101020211201010200002001221202110222012101100001122000212222122200011211012020110102121011220012010211110000000214-
420222022100202200021020111120202202101112022010000202022021020021100122001021111011222120201011100100020111220022112002211002102122202100001110112104-
410202221111201201010121002100021221211021122012202100201100101012002020112001220020011101100211011212200202011110122200000221100200210210101121220124-
400002102012101101210220022111121100202210221211211022212021201110200210011102120110020222000222211210121222110002120000122220122122211002111200100114-
411202201220202221222010001202121102222221212112222222201021001021121220011102011201022221120221210122121000110022222212200212010022202202121200120204-
402101201021002202120101221000101012220012220110010102022121001021220111012110010011210212122112222112021112002121000112121010120101101122010212110114-
444444444444444444444444444444444444444444444444444444444444444444444444444444444444444444444444444444444444444444444444444444444444444444444444444444-
