444444444444444444444444444444444444444444444444444444444444444444444444444444444444444444444444444444444444444444444444444444444444444444444444444444-
422012221002112100020111020200022202110122001021212002110121201101212220210001221021011012212202100201222211221001201121112212011000212212111101112214-
400211102011101012210221000001011101100020011221020001212220020020012121220200022200010212000120112101011201202221202211001121122111002001121000002214-
402110212002022201102020220100100200210010100011201122111100200002210200120222210012011222002111110222022200211002110100112101222021210110101212021014-
401101200212110220101221222210021111201002222000201002120111011221120210221211102120110012021120100110201121210212201222122002110212220121011012121114-
412212012222112002002012221220200000100220120112020111211022011111122000201102002110211102201100110010222010110211011001021220002101222002222002121204-
412000220122022010011010111021102002221121120220102222012011212121001202221212202010120220221111102200122121212022011211222112222222210000000012102204-
411022022001102000201221101210012212211212212121221020101122121022210211212212112000221112201022211021220011111221121201120120210001100012201000210104-
412210021002011210210122212021222112002000022001200211000202211121102121210210012220101110110212000100000012210220000221100021111222202101102211211224-
420210220012201210002212122110101202201210002102102022221122112120122222112122100110202000200111211202222000100011201110112210110121000112022011121124-
421112120122001000101112020110201210210101001210211122101120210222000120011011002010111201012221021011011022112110212201012121100100212122112120221214-
411011200201200222001211221010121201021001210122001201102210201212201011001220120202222021000202001010120110012101002102122121001100112111012121201104-
422001021212102022100002011002112111110121211110012010012221001212020012020201010102210100201112020220201001001201112210201211020110202002122202100024-
400110110011201101001220201221100102112212011120210021122211001120122201021101110110220022102202202220012120011102121210102210101101102112111220120214-
411111102120201000211201001100002020002110000212211111120010222012010221010221211002010210100112100101010110111002220202101220111022112120010021001024-
421010101202021221110121220000011121000110101222011210100201022121201012221022121210111011101122111020111102120010101100110222020012122110202202110124-
411021111211200122101010200022101021020012112011201210121100000122212010221022101220210220221110202112120001100220210101102002202021202110102202122214-
412001201210200022201101211011110120210202112220212010202011000000122122020001121001200021001010102202020122122102210000111112122011212002021012210014-
421100101212010010121112101002200211021112002120101100022102222202020201211100121022010011002020120101000000100120120100120121201111221201021110011204-
400022221120001222101122112021210020201121212110120022020000100212011100101120200220102210210001112121012122112210210121121202012200111202022201002114-
402102122111011201110000122121100010112220020221121200212201200002202111212202122012111020020101102101120220111200110010200222120212112010200010122124-
402211210200202012101121102211002121001000211012101022021101120221200212211122121020212121020202200101210121001012110102102211210121121202010210212114-
402202220112120111211120000122121221121102111021111211111200202011220122211102100202020120101002101002020110011102220020122201212221121122022111220224-
400202022022111002001211020202202000122100001022102101000011010121002220120202100200011102202222212201212121121001222111122202210020211211111101000224-
401102210100120120201021222220021122011221002001210012201101002212111200101102020001010000202022102212101120211201111220111120010210110012100011002024-
411212102210000010202001112211012102201211022012112002002212200210122220020010012220101220020021111121002101020111211212101220122211121222110022221204-
411200220211100101201011021012101001222011102000000211211120122022111010012222211001022102121012112222012121120101210220012222022202020001211200220224-
401010111220122010021200112220121112220122101211120102101020210022121102202021210101220111001110011002212112222201010010211121122121011000121010020224-
402012000122221011102001201001002220100012012001101111121122000221121010221222201201111010220000022001101121202021200111011200220100111020210202002104-
410020121012102211002021221110210002021102022111002220201112202120201012020102020122022210002111122201211220022202000201110010022211110101111110210124-
400121120221000020220122211100110221122212201002212011021110012001110211022210202102211110022021110000121102112011122201221100102101121220110122221004-
421222021011022021020220111010222110211102100202111121020012010002101121021200012122210212012201001110021022001200222220222021212220021201202022111114-
420211222002201211222021111111022001212121110011221100011221220121222220210001212221110021011012221010121110202211012210011222021001200222112120021124-
422012021010012011001221120100111221002212010102220001010201022002021220201222110121020221101210220112100010200010022221202211100002012212111210011214-
420110000120221012010002110022121000011001200212122212102021202200202220212222201212012120122010002012221200101211012221211101021011212202122100221104-
401200112110222002000001200120110212102220200211111011210011012012022000100210001120112101201210221101122200112122211022220012100112202222012220210124-
412200001010100011100222200220221120010021012122201012222222021112211112110122010201222010120120221210222111121010112112202212022210120211110112011004-
401100121120001222100212220221110212002221202000201012021212222210000001110012021112020110002222201011222102002002121111202202221002011102010000202114-
412222020201202212122122102201101000111210020011022021010211001200212201202120120201210202200120211112122202200122202222022220001202220211222101120014-
412112002122100212101121010201001010210222001011021112020211222000222000211002012212011122121112220222010021012012122121121001101100120021101000112204-
420211211022202221010102100001211120021010112022022201011121110020100122002220121010020010121011011222202122020211010112200001021111102121222120101124-
412010011220211110011210221120012022200012102010111120000002020011120002021011110012000010201000011012110222200120222012221122210121101000000102010224-
410012000100122000201010011101120020202210222120112210211101211202100000212011110022021110102222211202111200121101101002202011101122211020212222201204-
410022122011101000100201002122202120020011122121011001212011100100120022222110102112011101122221110111220121120100212110110120021112120101100202212024-
400020211201202112000110222222102101102120120120022020021210222000110122210201111011101211011220120021100112002111200222101202101012000121112101022204-
412112111102022001000021120012220022012021121010001121122100012200210001111021020200202011101100220000102112101112021002101211221200211220220000022224-
420001201001122010122202221101202111002200200212021212102011202011102101002022201122110212011221201121211210221020121010002220122010202221001011122014-
400122110011222001121002001110200122011112220212212100102012002022020210122120002121220002212201210221122101010201112201201122121202202211100021222014-
421202120100220211212210122121221021021121101021100112120120001020102101012100010012221221000120010001212010202120222022220212101122000010010110022214-
444444444444444444444444444444444444444444444444444444444444444444444444444444444444444444444444444444444444444444444444444444444444444444444444444444-
