444444444444444444444444444444444444444444444444444444444444444444444444444444444444444444444444444444444444444444444444444444444444444444444444444444-
402220102010010022100011120122111111021022100100002002111011210011202021202221210212020202112022111212220202021101110022102002110222121002011221220104-
411022100122010011122021222121222220222001002020202122110110012110120212120020120020112120012000211212122020012001200011200021021001011001001002202124-
422101110020121000200211222010210020111102100220212210220011002010002210220000101112112021012012112212101220101211121022002200022210022112122101022004-
421121110111002201202202210022022222101102222212100001022212121100211101000220100001222101021221200220012022201110022201001011111210110212210021210204-
421210212010012100202220011022222222112110022221201111122100122111002120200111101122102102100011011112112012202122120212112002112112122022202001111124-
411202200022021002122120110210112002111200001110011212122202222110001202220012112120202002220121202212111001220122121022102012112000002012020000100014-
401001212110011102100222221022102100022221202201222220010212212111200201020110021002112001110211200022121100200022211202010201220021120202212222111124-
402212012202122202212201111120200021001211221012202222122222001201120220221022221100111202120022111200200211100122101210221120022220221011200220212024-
420110010122022212202220101112020220011220010122011110221111122021012110021200200110100201201002101102010111112121102212212022011111022000021002121114-
402120110111112210211102000020200210002111101011121000010121201210110122100020001201001212100202201010112201211202012202122111020012112011221120211004-
422210102220012211002102000111100212000210001111100021100110211212220211210202211022100122011000120220112002100221022021001120200120220200111222212004-
420020220122102001001221211120111111112011220212111102111122010222100021210002211121212102101020110210001021112010011111002012001212021012000102100224-
412222021100101102002200102022112021220212112210111012002021010021221020202022212110121120112012020022020010010211002022221011212012000000001222220204-
420101102022020100220010001111011102002012222010111202120101020002111110220200100101221220012020121202102122001220200102111112110100011000020211222004-
422020121221121200002111001101122100000112202120222112022112101100002020201212202200001120212011101222202210100100100101021022201022102012112121120104-
401200011211110100220220010222021211222111122102021011022011201111012222101010121222020100010110021122111012221122202000210221022010000210110220200114-
422202211221212122120121202200120201211220100210111112022222010122011221211102121010222112210220010021022212100212021121000201121120100121222110120104-
412120201212012102012202002102221001100200222120121010112022221011121022221110111121101112202002100200211001120122012111021120102022011000021211122114-
400220000121020222202022021120110122110202202111101201222201211120121202202222011121212112010122111221220000110122021002200102121201010121200202221114-
401222201022211021022211001100102210000220210111211110021120002002010211201212222220000100201002011011211102211121111101212002211222100201020222120124-
400101101212111202222012020111122002001110110012111221111202212010201200021020020010120012022200112222111201122021222012201002202202211102201121210124-
402222120211022020112122100021210212202212020100212202111221001001220000022202101210020000121001200121121221022000211110122022010222011210110101220114-
401000212111220010100220212111022010222111112012122021121122100112020110002120201121212010202210122012102002102120022112022010220021001220020112000024-
402100001022122000012020012002000012102200200022022002102021121211011102202100012211001222011002212102102012212121001020010010200122202002212111211124-
412101220001210010120121112111001210012220120210110011020122020200212001212012100202001122211101100100001220100111212211110112200200001101001020001224-
422101010101011121011220200011102201200022121211121210100100110120101210001202022000102022010222120110002200210212020201021020211201211002001012020004-
412212001002121121002021221001101211002000210111012121022221022122202020121121111220201001020020222012122122001211222100100022101112200022120220101024-
412012222200211120121220121210202202011010002110110110112021012000001222202211102022022202222111112112010012201212022221112112112221212101200101021104-
421221210000212211022122010110201202120102112211010122201020111211110121010201111111010222210012222111110020012222022121100220202120222122002101021024-
422102000122122111110202110021100122002012122000221202102210101200222210210120211201212011011100002210212121200120222011222122002210121020202020110104-
402222200221202120200101012212221211022022001021002211212210021221012212010110102001012020120022010020210000112200110122022222011002002120210010100014-
401010010120102210012202000201220011102020100212000200222002011220012002021110001210210211112002201010012212221000202002212022210102020202010121111024-
420022022020001002020110220012222002012220221111020012020000021210101211111102211110111020110210101111101021112000010122021111010121121012212111221014-
400222122000011210010102200202202020020000221201012110101210201100120222220001111210010211012200210000220111122100012201122101011111222000210010121124-
411112220200012102202100111102210211121011202121110102010021221111021210221110002000221222202011021222121101011110021102010211021002202122210221021114-
420112101120112112201211202212121202021110221022221221220020000121201012222122021120101211111102021210000220121022022112011011212201211221022112210024-
402020101012222210122111002210122021021110220111220120120010021211001102122112210000001020211101010020221101212201100101212110222022111220022011100214-
410100121202122112001202021220222222201212120211000120202002222220112210100101210002001110221220122202110102201001100100210200121120002020011010002204-
410002100121001222000112111121021200201212211112111120000010121201102012010122220102110020201201222220022002202001122201011020110222110211200221020224-
421200221122011210010001020210012201210002122121121011002110111102021010101022210200022212102121100210101022211211122002212110100221220200200002211124-
401010000200220111012120211100020102022000021212212210202011021120210002101011121222120002012220212112122101201121101201121221021001212022122100101114-
411210200112121012101211122211202102112220211200220210022022011002002212102120000222012202001200202212220011201121010001121210121001202012200002221004-
411112201211210221120022221020211212220200221212001000202122110222110121002220200111220102110201222100100021020221101011120021222102022110010210111104-
421101221012221221210200002101221012001000102121120100201200202101012022221221111101022220200211212212022101120010001122011211220202011002021121101104-
412122110001220120100001202102201202220001120201112001222010001012101112110122202011221100011022212212002221101210022102012212212121021111020022222004-
400222001220112200222021022011212122102020202222001221220011100110000222212222110100012001001012020202112211021120010200021210002102000000001200222104-
411002211201011212210012120112020011010221201012120110222112010010202022011101111200002002012221201010100121221021202020001001102221001111212211221124-
402020110110021020100211101101001112201110021121211222222001000022001110011101202211210101222120000122021220111201112112201020121102221200020022022214-
444444444444444444444444444444444444444444444444444444444444444444444444444444444444444444444444444444444444444444444444444444444444444444444444444444-
