444444444444444444444444444444444444444444444444444444444444444444444444444444444444444444444444444444444444444444444444444444444444444444444444444444-
410020211012120201201212011221122210001202000010102121001222220122221022222101102102121001100120021211000102212222222121210122221022000022110100002224-
400120000222010221011112220002112200120120102220022111001101202010021010112211221201122020120000111110212211211202200110122011200201120111111120222204-
420120210222211022110001210222111112021221210002122121120022212220210100211102021210221111202222012221202021222112220002100010110112121110100011112004-
421022222111100000220100110021121001021202120120112001021122021212201101120002210202120122021100201122210221020002110222021000021201221012221202002224-
410020222021121222112022021021121210111010211020112122100001200110201212110011012010111000100102210211012021211011110000012220101110211010120211120204-
420012111121122122212010211220200100200011211011122020012102022222002022022011202010122021221111211012002022222101222212212010201000012212211201011204-
400121120200110010220222202200120200021221000122122121120202202212000221121221010010022200111222120202210202122121000012221000102012221120221222001204-
400221122112001012222200212010000111000010011002222100201201011020020011011011011010122121211011121122222112201112102221011200110002100221012022020104-
410210110201100021221022111212200211210010102001201011022001220202202001011111100100000112121100101111200101120200221201212101222002222221100112220014-
410021012012101001101202220000220222112101121202212121112100222220012010021021012112100122110110021011022220212202112112200002002002011000111122212024-
421122010001201102102002200011102120222012012210011011120112001202112110001110110200010021110020211200101202120222021121210122120222001121112210022004-
420220121220210221010110210110001121000010201110112202202021000201001110000112102112111222202100200012010210102020011002112111012112120200211221200014-
421201201000110002112120012012121002021000210110022222111122012011120201111100100001020220012112220201022111100112222201202211012200202212022102201214-
412202200220121221022201021222021220022121222101110021111222002222102002022010100020122101101011200102111000122220212010001022222100222122001121012124-
401200000121002101222101222021012000122100201011210002022001201001222001202111222012102220110202022110011000000100020010112012002200101021100112020224-
400002120122100221012202210201220201112200021000100101201021210002110001000111102210021102000012000002020021202021110122100110210121122112120220200114-
401021210020220122012112220201122221000201010122102122022011202211020010102010220200122222201111012010202100001220100022211101111201011121111221012114-
401120012221022012210220210022122101001012102100222120121222022210011011120021121001121010121000002111002122120221221022102200100100111101102002200004-
401121222101220111010211022020011012221001110010102021221221012102121221020022120112011022002100010112111222200111112111010201221020211001120201010114-
402200111222022101011100021212222100220012112021011111200202002100021000100210210211201100111200000021210110210000212220020011220021000200121120011114-
402222211021000020202112100111221211101221122122012210112022202101111121101020001221202211010220101222021221000212120021112000102112120202101210201214-
411122020101110221222121120122222001222202021122000201122002000010202111211122011122202100012120102112110001220121010112120122102222102111201220121204-
410201000011221222020212002210101002201122210202221022200001101202201221020111021012211122000000001020221101121022022002012010210010010111022002000104-
412112200002210210212110011121210222121121210201111202211120212221121010221122100201202121111000022102011211212000012210120020001220200222200021000224-
400202000102100210222112002201112120100121010102122010110202211102100202111120220100221011201100000210110120222102222011211020011011010212220102101104-
412221022220221212022200002120002222002002000200100120110120121122020002110210211220002200112001120110200220110201211211002210111012100020101110121104-
401010201111101220212221020110200220221012122200012000012121221120022211101021022110220020112011001100100201110100101212120102022021200020210021000104-
402221022010122102101210111101222222202220212101120110221101002220221012222121101101010220001112221112002112101202101211020101001212120020020222112204-
421101120111022011220120211012002212110010200001212110122120012111100002211212210111110021201211012112022100100022212112121222201010002121100022102204-
410122012102012021200200011020011022220102112121021212201012001000111020010011201121222220000022202112020212212011022200002120220022002112020011212114-
411020222011020000000211210222121212112202021222001010200121221010201210020210010121020102212012111120122201022201211011101112111201010102210122020114-
401021111220001211211211111211212200001220110101101101102201111202101221011122010200122220110222012221021100021120010221122122111000201022011022000214-
400121211021011111220020222002011022202222020202100012220122102201000121110012100012002022102020011201101021021222112110211201202021210102002021220224-
411112110201120222012111200012202111111111221221222020011201122012200021222211102212000002201022101221220012121000100212212022200221012020001102101124-
401122101110000200110001010010000011011122120120020022020010110111211021121220222120100000220100221121102112202120202101112121211222102212211211221024-
412121120220010220211120201010000111202002221212200100100002221200100022111011022221212000002110220020100020021110020020010010212101111022120121122024-
400112110110110202200122222000200020020122211122100110202122022102111120211202202200110121001200100022221202111210221111102000101122002212012002020114-
421121120220211220000202110022101222211002211012022000021111202100202112112020000012111112110020022010011011110111022010010222000122000002001102020024-
421022200022122101001022012000112221100002012100012200211201120120012101022220012222022112121122111011122001201222012212010112111222010122011002021224-
402202222200100220211011120011111001212102202012211120022200201120021221022201021200002012100211002201012202212012101020122211110022012201102111100114-
420012011112102212000201010220112000012111200012102022021012000010020021002200000010211120211010221110021012021100011200020212200010002102020112020104-
420110001020122002000121201010200222202001010111110100022112112212112101010211010102100111011122110102011021221020001201200121000201112110212211202224-
400202200212111020210212122002102211122202121111122202020012021122110222120011212120110120001101011120200022221002212012022012122001101220200021010114-
420001202002011122100221210022200000012101100110211001202202221012111022021012210201112010001011121022001011220010020020201110110021202211200011121204-
401011212120022012211122210101202011111021101020011002111212122111211222222202100021110102021120212202101200022221222011012000011100100212022212000204-
422102010111112100222122001100012110002210111200211111002020101121120210121101121111101012011210002220222220021120112221122011022211011112122002102224-
412021211220120000111211022202202000022020202210222210220012201100202202010210112212012120211021012112100120000112112210220012121021021010221020011124-
410201200020021212122102102022111211121112021002012112111211002211111122012222202220110101011021210211110212222220222110001122111002020021122211120004-
444444444444444444444444444444444444444444444444444444444444444444444444444444444444444444444444444444444444444444444444444444444444444444444444444444-
